{
  "ntuples": 50,
  "tuples": [
    {
      "r1": 50,
      "c1": 50,
      "r2": 64,
      "c2": 47
    },
    {
      "r1": 50,
      "c1": 50,
      "r2": 66,
      "c2": 51
    },
    {
      "r1": 50,
      "c1": 50,
      "r2": 39,
      "c2": 55
    },
    {
      "r1": 50,
      "c1": 50,
      "r2": 52,
      "c2": 39
    },
    {
      "r1": 50,
      "c1": 50,
      "r2": 38,
      "c2": 41
    },
    {
      "r1": 50,
      "c1": 50,
      "r2": 43,
      "c2": 40
    },
    {
      "r1": 50,
      "c1": 50,
      "r2": 33,
      "c2": 44
    },
    {
      "r1": 50,
      "c1": 50,
      "r2": 47,
      "c2": 63
    },
    {
      "r1": 50,
      "c1": 50,
      "r2": 64,
      "c2": 42
    },
    {
      "r1": 50,
      "c1": 50,
      "r2": 63,
      "c2": 61
    },
    {
      "r1": 50,
      "c1": 50,
      "r2": 58,
      "c2": 37
    },
    {
      "r1": 50,
      "c1": 50,
      "r2": 36,
      "c2": 37
    },
    {
      "r1": 50,
      "c1": 50,
      "r2": 41,
      "c2": 54
    },
    {
      "r1": 50,
      "c1": 50,
      "r2": 60,
      "c2": 58
    },
    {
      "r1": 50,
      "c1": 50,
      "r2": 64,
      "c2": 37
    },
    {
      "r1": 50,
      "c1": 50,
      "r2": 36,
      "c2": 60
    },
    {
      "r1": 50,
      "c1": 50,
      "r2": 54,
      "c2": 68
    },
    {
      "r1": 50,
      "c1": 50,
      "r2": 59,
      "c2": 58
    },
    {
      "r1": 50,
      "c1": 50,
      "r2": 63,
      "c2": 60
    },
    {
      "r1": 50,
      "c1": 50,
      "r2": 69,
      "c2": 54
    },
    {
      "r1": 50,
      "c1": 50,
      "r2": 66,
      "c2": 42
    },
    {
      "r1": 50,
      "c1": 50,
      "r2": 56,
      "c2": 59
    },
    {
      "r1": 50,
      "c1": 50,
      "r2": 60,
      "c2": 51
    },
    {
      "r1": 50,
      "c1": 50,
      "r2": 62,
      "c2": 62
    },
    {
      "r1": 50,
      "c1": 50,
      "r2": 51,
      "c2": 39
    },
    {
      "r1": 50,
      "c1": 50,
      "r2": 50,
      "c2": 66
    },
    {
      "r1": 50,
      "c1": 50,
      "r2": 34,
      "c2": 47
    },
    {
      "r1": 50,
      "c1": 50,
      "r2": 61,
      "c2": 47
    },
    {
      "r1": 50,
      "c1": 50,
      "r2": 43,
      "c2": 66
    },
    {
      "r1": 50,
      "c1": 50,
      "r2": 33,
      "c2": 58
    },
    {
      "r1": 50,
      "c1": 50,
      "r2": 44,
      "c2": 40
    },
    {
      "r1": 50,
      "c1": 50,
      "r2": 48,
      "c2": 60
    },
    {
      "r1": 50,
      "c1": 50,
      "r2": 44,
      "c2": 59
    },
    {
      "r1": 50,
      "c1": 50,
      "r2": 60,
      "c2": 49
    },
    {
      "r1": 50,
      "c1": 50,
      "r2": 50,
      "c2": 32
    },
    {
      "r1": 50,
      "c1": 50,
      "r2": 65,
      "c2": 51
    },
    {
      "r1": 50,
      "c1": 50,
      "r2": 34,
      "c2": 43
    },
    {
      "r1": 50,
      "c1": 50,
      "r2": 44,
      "c2": 42
    },
    {
      "r1": 50,
      "c1": 50,
      "r2": 66,
      "c2": 41
    },
    {
      "r1": 50,
      "c1": 50,
      "r2": 53,
      "c2": 68
    },
    {
      "r1": 50,
      "c1": 50,
      "r2": 61,
      "c2": 54
    },
    {
      "r1": 50,
      "c1": 50,
      "r2": 33,
      "c2": 43
    },
    {
      "r1": 50,
      "c1": 50,
      "r2": 42,
      "c2": 62
    },
    {
      "r1": 50,
      "c1": 50,
      "r2": 43,
      "c2": 67
    },
    {
      "r1": 50,
      "c1": 50,
      "r2": 35,
      "c2": 43
    },
    {
      "r1": 50,
      "c1": 50,
      "r2": 66,
      "c2": 53
    },
    {
      "r1": 50,
      "c1": 50,
      "r2": 61,
      "c2": 45
    },
    {
      "r1": 50,
      "c1": 50,
      "r2": 59,
      "c2": 46
    },
    {
      "r1": 50,
      "c1": 50,
      "r2": 36,
      "c2": 47
    },
    {
      "r1": 50,
      "c1": 50,
      "r2": 38,
      "c2": 47
    }
  ]
}