{
  "ntuples": 50,
  "tuples": [
    {
      "r1": 3000,
      "c1": 3000,
      "r2": 2949,
      "c2": 3027
    },
    {
      "r1": 3000,
      "c1": 3000,
      "r2": 3102,
      "c2": 3040
    },
    {
      "r1": 3000,
      "c1": 3000,
      "r2": 2986,
      "c2": 2876
    },
    {
      "r1": 3000,
      "c1": 3000,
      "r2": 2923,
      "c2": 2929
    },
    {
      "r1": 3000,
      "c1": 3000,
      "r2": 2845,
      "c2": 2935
    },
    {
      "r1": 3000,
      "c1": 3000,
      "r2": 3034,
      "c2": 3081
    },
    {
      "r1": 3000,
      "c1": 3000,
      "r2": 3044,
      "c2": 3021
    },
    {
      "r1": 3000,
      "c1": 3000,
      "r2": 3015,
      "c2": 3010
    },
    {
      "r1": 3000,
      "c1": 3000,
      "r2": 3044,
      "c2": 2951
    },
    {
      "r1": 3000,
      "c1": 3000,
      "r2": 3014,
      "c2": 2878
    },
    {
      "r1": 3000,
      "c1": 3000,
      "r2": 3062,
      "c2": 2985
    },
    {
      "r1": 3000,
      "c1": 3000,
      "r2": 2994,
      "c2": 2849
    },
    {
      "r1": 3000,
      "c1": 3000,
      "r2": 3035,
      "c2": 2911
    },
    {
      "r1": 3000,
      "c1": 3000,
      "r2": 2918,
      "c2": 3015
    },
    {
      "r1": 3000,
      "c1": 3000,
      "r2": 3087,
      "c2": 3097
    },
    {
      "r1": 3000,
      "c1": 3000,
      "r2": 2995,
      "c2": 3001
    },
    {
      "r1": 3000,
      "c1": 3000,
      "r2": 3024,
      "c2": 2980
    },
    {
      "r1": 3000,
      "c1": 3000,
      "r2": 3004,
      "c2": 2973
    },
    {
      "r1": 3000,
      "c1": 3000,
      "r2": 2994,
      "c2": 3004
    },
    {
      "r1": 3000,
      "c1": 3000,
      "r2": 3158,
      "c2": 3036
    },
    {
      "r1": 3000,
      "c1": 3000,
      "r2": 3133,
      "c2": 2899
    },
    {
      "r1": 3000,
      "c1": 3000,
      "r2": 3048,
      "c2": 3037
    },
    {
      "r1": 3000,
      "c1": 3000,
      "r2": 3064,
      "c2": 3011
    },
    {
      "r1": 3000,
      "c1": 3000,
      "r2": 3002,
      "c2": 2993
    },
    {
      "r1": 3000,
      "c1": 3000,
      "r2": 2888,
      "c2": 3077
    },
    {
      "r1": 3000,
      "c1": 3000,
      "r2": 3096,
      "c2": 2950
    },
    {
      "r1": 3000,
      "c1": 3000,
      "r2": 2952,
      "c2": 3092
    },
    {
      "r1": 3000,
      "c1": 3000,
      "r2": 3139,
      "c2": 2892
    },
    {
      "r1": 3000,
      "c1": 3000,
      "r2": 3064,
      "c2": 2926
    },
    {
      "r1": 3000,
      "c1": 3000,
      "r2": 2954,
      "c2": 2840
    },
    {
      "r1": 3000,
      "c1": 3000,
      "r2": 3085,
      "c2": 2993
    },
    {
      "r1": 3000,
      "c1": 3000,
      "r2": 3035,
      "c2": 3059
    },
    {
      "r1": 3000,
      "c1": 3000,
      "r2": 3161,
      "c2": 2956
    },
    {
      "r1": 3000,
      "c1": 3000,
      "r2": 2970,
      "c2": 3036
    },
    {
      "r1": 3000,
      "c1": 3000,
      "r2": 3013,
      "c2": 3020
    },
    {
      "r1": 3000,
      "c1": 3000,
      "r2": 3017,
      "c2": 2973
    },
    {
      "r1": 3000,
      "c1": 3000,
      "r2": 2898,
      "c2": 3054
    },
    {
      "r1": 3000,
      "c1": 3000,
      "r2": 3052,
      "c2": 3028
    },
    {
      "r1": 3000,
      "c1": 3000,
      "r2": 2823,
      "c2": 3025
    },
    {
      "r1": 3000,
      "c1": 3000,
      "r2": 2894,
      "c2": 2906
    },
    {
      "r1": 3000,
      "c1": 3000,
      "r2": 3015,
      "c2": 2996
    },
    {
      "r1": 3000,
      "c1": 3000,
      "r2": 2888,
      "c2": 3062
    },
    {
      "r1": 3000,
      "c1": 3000,
      "r2": 2992,
      "c2": 2898
    },
    {
      "r1": 3000,
      "c1": 3000,
      "r2": 3029,
      "c2": 2999
    },
    {
      "r1": 3000,
      "c1": 3000,
      "r2": 2988,
      "c2": 2984
    },
    {
      "r1": 3000,
      "c1": 3000,
      "r2": 3038,
      "c2": 2909
    },
    {
      "r1": 3000,
      "c1": 3000,
      "r2": 3058,
      "c2": 2980
    },
    {
      "r1": 3000,
      "c1": 3000,
      "r2": 3048,
      "c2": 2877
    },
    {
      "r1": 3000,
      "c1": 3000,
      "r2": 2905,
      "c2": 2907
    },
    {
      "r1": 3000,
      "c1": 3000,
      "r2": 2870,
      "c2": 3037
    }
  ]
}