{
  "ntuples": 10,
  "tuples": [
    {
      "r1": 3000,
      "c1": 3000,
      "r2": 3174,
      "c2": 4180,
      "ratio": 0.1227
    },
    {
      "r1": 3000,
      "c1": 3000,
      "r2": 3519,
      "c2": 1986,
      "ratio": 0.9872
    },
    {
      "r1": 3000,
      "c1": 3000,
      "r2": 3212,
      "c2": 2206,
      "ratio": 0.6167
    },
    {
      "r1": 3000,
      "c1": 3000,
      "r2": 2048,
      "c2": 3250,
      "ratio": 0.6668
    },
    {
      "r1": 3000,
      "c1": 3000,
      "r2": 3062,
      "c2": 3060,
      "ratio": 0.9251
    },
    {
      "r1": 3000,
      "c1": 3000,
      "r2": 2921,
      "c2": 3185,
      "ratio": 0.1044
    },
    {
      "r1": 3000,
      "c1": 3000,
      "r2": 3178,
      "c2": 3371,
      "ratio": 0.4403
    },
    {
      "r1": 3000,
      "c1": 3000,
      "r2": 4374,
      "c2": 3073,
      "ratio": 0.4084
    },
    {
      "r1": 3000,
      "c1": 3000,
      "r2": 3487,
      "c2": 1354,
      "ratio": 0.9491
    },
    {
      "r1": 3000,
      "c1": 3000,
      "r2": 2869,
      "c2": 1984,
      "ratio": 0.9505
    }
  ]
}