{
  "ntuples": 10,
  "tuples": [
    {
      "r1": 30,
      "c1": 30,
      "r2": 26,
      "c2": 29,
      "ratio": 0.7556
    },
    {
      "r1": 30,
      "c1": 30,
      "r2": 29,
      "c2": 36,
      "ratio": 0.8523
    },
    {
      "r1": 30,
      "c1": 30,
      "r2": 34,
      "c2": 38,
      "ratio": 0.6917
    },
    {
      "r1": 30,
      "c1": 30,
      "r2": 34,
      "c2": 34,
      "ratio": 0.0908
    },
    {
      "r1": 30,
      "c1": 30,
      "r2": 38,
      "c2": 34,
      "ratio": 0.6439
    },
    {
      "r1": 30,
      "c1": 30,
      "r2": 33,
      "c2": 37,
      "ratio": 0.0051
    },
    {
      "r1": 30,
      "c1": 30,
      "r2": 23,
      "c2": 27,
      "ratio": 0.3601
    },
    {
      "r1": 30,
      "c1": 30,
      "r2": 24,
      "c2": 33,
      "ratio": 0.4007
    },
    {
      "r1": 30,
      "c1": 30,
      "r2": 33,
      "c2": 27,
      "ratio": 0.3459
    },
    {
      "r1": 30,
      "c1": 30,
      "r2": 32,
      "c2": 24,
      "ratio": 0.3164
    }
  ]
}